2 2 2 2 2 6 6 2 2 2 2 2 2 2 2 2 2 2 2 2 2 2 2 2 2 2 2 2 2 2 2 2 2 2 2 2
2 0 0 0 0 0 0 0 0 0 0 0 0 0 8 0 0 0 0 0 8 0 0 0 9 0 0 0 0 0 0 0 0 0 0 2
2 0 0 0 0 0 0 9 0 0 0 9 9 9 8 0 0 0 0 0 8 0 0 0 9 0 0 0 0 0 0 0 0 0 0 2
2 0 0 9 9 9 9 9 0 0 0 0 0 0 8 4 7 7 7 7 8 0 0 0 9 0 0 0 9 9 0 0 9 0 0 2
2 0 0 9 0 0 0 9 0 0 0 0 0 0 8 0 0 0 0 0 0 0 0 0 0 0 0 0 9 0 0 0 9 3 0 2
2 9 0 0 0 0 0 9 0 0 0 9 0 3 8 0 0 0 0 0 0 0 0 0 9 9 9 9 9 0 9 9 9 0 0 2
2 0 0 0 0 9 9 0 0 9 9 9 9 9 8 0 0 0 0 0 8 0 0 0 0 9 0 0 9 0 9 0 9 9 9 2
2 9 9 0 0 0 0 0 0 0 0 0 0 0 0 0 0 0 0 0 8 0 0 9 9 9 0 0 0 0 9 0 9 0 0 2
2 0 0 0 0 0 0 0 0 0 0 0 0 0 8 0 0 0 0 0 8 0 0 0 0 9 0 0 0 0 0 0 9 0 0 2
2 1 0 0 1 1 1 1 1 1 1 1 1 1 1 4 7 7 7 7 8 0 0 0 0 0 0 0 9 9 9 9 9 0 0 2
2 0 0 0 9 0 0 9 0 0 0 0 0 0 0 0 0 0 0 0 8 9 9 9 9 0 0 0 0 0 0 0 0 0 0 2
2 0 0 0 0 0 0 9 9 9 9 0 0 0 0 0 0 0 0 0 0 0 0 0 0 0 0 0 0 9 0 0 0 9 9 2
2 0 0 0 0 0 0 9 0 0 0 0 0 0 8 0 0 0 0 0 0 0 0 0 0 0 0 0 0 9 0 0 0 0 0 2
2 0 0 9 9 9 0 0 0 0 9 9 0 0 8 4 7 7 7 7 1 1 1 1 1 1 1 1 1 1 1 1 1 1 0 2
2 0 0 9 0 9 0 0 0 0 9 0 0 0 8 0 0 0 0 0 0 0 0 0 0 9 0 0 9 0 0 0 0 0 0 2
2 0 0 0 0 9 0 0 0 0 9 9 9 9 8 0 0 0 0 0 0 0 9 9 9 9 0 0 9 0 0 0 0 0 0 2
2 9 9 9 9 9 9 9 0 0 0 0 0 0 8 0 0 0 0 0 8 0 9 0 0 9 0 0 0 0 0 9 9 9 9 2
2 0 0 0 0 0 0 0 0 0 0 0 0 0 8 0 0 0 0 0 8 0 9 0 0 0 0 0 0 0 0 0 0 0 0 2
2 0 0 0 0 0 9 9 9 9 9 9 9 9 8 0 0 0 0 0 8 0 0 0 0 0 0 0 0 0 9 9 9 0 0 2
2 0 0 9 0 0 0 0 9 0 0 0 0 0 8 0 0 0 0 0 8 0 0 0 0 9 9 9 0 0 9 0 9 0 0 2
2 0 3 9 0 0 0 0 0 0 0 9 0 0 0 0 0 0 0 0 8 0 0 0 0 9 3 0 0 0 0 0 9 0 0 2
2 2 2 2 2 2 2 2 2 2 2 2 2 2 2 2 2 2 2 2 2 2 2 2 2 2 2 2 2 2 2 2 2 2 2 2
0 0 0 0 0 0 0 0 0 0 0 0 0 0 0 0 0 0 0 0 0 0 0 0 0 0 0 0 0 0 0 0 0 0 0 0
0 0 0 0 0 0 0 0 0 0 0 0 0 0 0 0 0 0 0 0 0 0 0 0 0 0 0 0 0 0 0 0 0 0 0 0
