2 2 4 4 2 0 0 2 2 2 2 2 2 2 2 2 2 2 2 2 2 2 2 2 2 2 2 2 2 2 2 2 2 2 2 2
2 0 0 0 0 0 0 0 0 0 0 1 0 1 0 0 0 0 0 1 0 0 1 0 0 0 0 0 1 0 0 0 0 0 4 2
2 3 3 3 3 3 0 0 0 0 0 1 0 1 0 0 0 0 0 1 0 0 0 0 0 1 0 0 0 0 0 0 0 0 0 2
2 0 0 0 0 1 0 0 1 0 4 0 0 1 6 7 7 7 7 1 4 0 0 0 0 1 0 0 3 3 3 3 3 0 0 2
2 0 0 0 0 3 3 0 3 3 3 3 3 1 0 0 0 0 0 1 3 3 3 3 3 3 3 3 0 0 0 0 0 0 0 2
2 3 3 3 3 0 0 0 0 0 0 1 0 1 0 0 0 0 0 1 0 1 0 0 0 0 0 0 1 0 3 3 3 0 0 2
2 0 4 0 0 4 0 3 3 3 3 0 0 1 0 0 0 0 0 0 0 0 0 0 0 0 0 0 0 0 1 0 1 0 0 2
2 0 0 0 0 0 0 0 0 0 1 3 0 1 0 0 0 0 0 1 3 3 3 3 3 0 0 1 0 0 1 0 1 0 0 2
2 3 3 0 3 3 3 0 0 0 0 0 0 0 0 0 0 0 0 1 0 0 0 0 0 0 0 1 0 0 0 0 1 0 0 2
2 0 0 0 0 0 1 0 0 0 0 0 0 1 0 0 0 0 0 1 0 0 0 0 0 0 0 1 0 0 0 0 1 0 0 2
2 1 1 1 0 0 1 1 1 1 1 1 1 1 6 7 7 7 7 1 3 3 3 3 3 0 3 3 0 3 3 3 3 0 0 2
2 0 0 0 0 0 0 0 1 0 0 0 0 0 0 0 0 0 0 1 0 0 0 0 0 0 1 0 0 0 0 0 0 0 0 2
2 3 3 0 0 0 0 0 0 0 0 1 0 1 0 0 0 0 0 1 0 0 0 0 3 3 3 0 0 1 0 0 3 3 3 2
2 4 0 0 3 3 3 3 0 0 3 3 0 1 0 0 0 0 0 0 0 0 0 0 0 0 0 0 0 1 0 0 0 0 0 2
2 0 1 0 0 0 0 1 0 0 1 0 0 1 6 7 7 7 7 1 1 1 1 1 1 1 1 1 1 1 1 1 1 0 0 2
2 3 3 3 3 3 3 3 0 0 3 3 3 1 0 0 0 0 0 0 0 3 0 0 0 0 0 0 1 0 1 0 0 0 0 2
2 0 0 0 0 1 0 0 0 0 0 0 0 1 0 0 0 0 0 0 0 3 0 0 3 3 3 3 3 3 3 0 3 3 3 2
2 0 0 0 0 0 0 0 0 0 0 0 0 1 0 0 0 0 0 1 0 3 0 0 0 0 0 0 1 0 0 0 0 0 0 2
2 0 0 3 3 3 3 3 3 3 3 3 3 1 0 0 0 0 0 1 0 3 0 0 0 0 3 3 3 0 0 0 1 0 0 2
2 0 0 1 0 0 0 0 0 0 0 0 0 1 0 0 0 0 0 1 0 0 0 3 0 0 0 0 0 0 3 3 3 0 0 2
2 0 0 0 0 0 0 0 1 0 0 0 0 0 0 0 0 0 0 1 0 0 0 3 0 0 0 0 0 0 0 0 1 0 0 2
2 2 2 2 2 2 2 2 2 2 2 2 2 2 2 2 2 2 2 2 2 2 2 2 2 2 2 2 2 2 2 2 2 2 2 2
0 0 0 0 0 0 0 0 0 0 0 0 0 0 0 0 0 0 0 0 0 0 0 0 0 0 0 0 0 0 0 0 0 0 0 0
0 0 0 0 0 0 0 0 0 0 0 0 0 0 0 0 0 0 0 0 0 0 0 0 0 0 0 0 0 0 0 0 0 0 0 0
